################################
#..............................#
#...####...###...####.....###..#
#...###....###...####.....###..#
#...####...###...##.#.....###..#
#..............................#
#...###......######...#######..#
#............######...#######..#
#.....................#######..#
#..###...#########.............#
#..###...#########........###..#
#..###....................###..#
#..###...###########...........#
#..###...###########.......###.#
#..###.....................###.#
#..........................###.#
#..##..###..###....#####...###.#
#..##..###..###....#####...###.#
#......###..###................#
#..##..###..###................#
#..##..###..###......########..#
#..##................########..#
#..............................#
################################