################################
#..............................#
#...$$$$...###...%%%%...@.!!!..#
#...$$$....###...%%%%.....!!!..#
#...$$$$...###...%%.%.....!!!..#
#..............................#
#.@.!!!....@.------...%%%%%%%..#
#............------...%%%%%%%..#
#.....................%%%%%%%..#
#..%%%...$$$$$$$$$.@...........#
#..%%%...$$$$$$$$$........###..#
#..%%%....................###..#
#.@%%%...###########.@.........#
#..%%%...###########........##.#
#..%%%......................##.#
#..........................###.#
#..??..###..???....!!!!!...###.#
#..??..###..???....!!!!!...###.#
#......###..???................#
#..!!@.###..???................#
#..!!..###..???....@.--------..#
#..............................#
################################