################################
#....@.........................#
#...$$$$...###...%%%%....@!!!..#
#...$$$....###...%%%%.....!!!..#
#...$$$$...###...%%.%.....!!!..#
#..............................#
#..@!!!.....@------...%%%%%%%@.#
#............------...%%%%%%%..#
#.....................%%%%%%%..#
#..%%%...$$$$$$$$$@............#
#..%%%...$$$$$$$$$........###..#
#..%%%....................###..#
#.@%%%...###########@..........#
#..%%%...###########........##.#
#..%%%.....................@##.#
#..........................###.#
#..--..#.#..$.$....!!!!!...###.#
#.@--..###..$$$....!!!!!...###.#
#......###..$$$................#
#..!!@.###..$$$................#
#..!!..###..$$$.....@--------..#
#..............................#
################################