################################
#..............................#
#...$$$$...###...%%%%...@.!!!..#
#...$$$....###...%%%%.....!!!..#
#...$$$$...###...%%.%.....!!!..#
#..............................#
#.@.!!!....@.------...%%%%%%%..#
#............------...%%%%%%%..#
#.....................%%%%%%%..#
#..%%%...$$$$$$$$$.@...........#
#..%%%...$$$$$$$$$........###..#
#..%%%....................###..#
#.@%%%...###########.@.........#
#..%%%...###########........##.#
#..%%%......................##.#
#..........................###.#
#..$$..###..---....!!!!!...###.#
#..$$..###..---....!!!!!...###.#
#......###..---................#
#..!!@.###..---................#
#..!!..###..---....@.--------..#
#..............................#
################################