################################
#..............................#
#...$$$$...###...%%%%...@.!!!..#
#...$$$....###...%%%%.....!!!..#
#...$$$$...###...%%.%.....!!!..#
#..............................#
#.@.!!!....@.------...%%%%%%%..#
#............------...%%%%%%%..#
#.....................%%%%%%%..#
#..%%%...$$$$$$$$$.@...........#
#..%%%...$$$$$$$$$........###..#
#..%%%....................###..#
#.@%%%...###########.@.........#
#..%%%...###########........##.#
#..%%%......................##.#
#..........................###.#
#..--..###..$$$....!!!!!...###.#
#..--..###..$$$....!!!!!...###.#
#......###..$$$................#
#..!!@.###..$$$................#
#..!!..###..$$$....@.--------..#
#..............................#
################################